3 3 2559 1914 3387 
3 8 3387 1909 2255 3348 3327 3312 981 3294 
3 5 2559 2028 1715 3471 1891 
3 3 1891 2482 726 
3 7 3294 2122 3258 1601 3229 2198 406 
3 9 406 1777 2378 864 1286 2133 586 2324 3078 
3 14 3294 2122 3258 3242 2046 3216 3208 2380 3175 949 2052 3146 3145 1844 
3 3 3145 1744 2510 
3 4 3187 3181 3171 2052 
3 5 3078 1317 1293 719 2038 
3 20 3078 1378 3048 3028 1997 2996 2980 2966 2943 1384 1416 2170 1944 2834 2828 2822 2808 1254 867 2392 
3 11 2170 2097 1110 2848 1545 1214 1440 2849 2449 454 1274 
3 20 2038 928 1879 1878 2461 1826 3010 3005 1836 1795 2984 2993 1332 574 784 1021 94 2977 363 1724 
3 11 2559 1628 2246 3377 1358 2245 3323 1333 2460 1063 2278 
3 15 2278 1875 3226 2222 3186 550 2242 758 3153 2152 744 1716 52 363 1724 
3 17 2559 3412 834 3413 2039 3415 1524 2475 528 3417 2436 1537 3450 1874 3444 2343 3461 
3 9 2278 3261 2319 305 2196 1133 1467 3248 3250 
3 7 1537 3422 2386 1492 3384 1739 1739 
3 6 2392 2267 2796 1369 1325 1639 
3 8 1639 360 2158 475 986 2449 454 1274 
3 16 1724 2944 1015 3025 489 3046 1625 178 77 1130 224 515 564 256 2180 1102 
3 18 1786 447 883 1423 1970 1477 2897 2894 598 2885 1664 1488 375 2930 2923 2928 2925 2067 
3 3 1102 1786 447 
3 3 2307 2067 2925 
1 4 3461 1343 1479 1739 
3 20 3461 3470 3454 1307 1195 3493 1370 1414 1030 118 1043 1862 551 3540 1270 1156 921 1374 3478 214 
3 10 214 1145 203 605 3280 3218 911 2508 273 224 
3 6 2736 2744 2557 2759 1263 2392 
3 5 224 2860 590 69 2783 
3 23 2783 334 1352 435 84 2789 2780 2228 2774 677 2491 887 1543 1907 2421 1591 666 1335 85 2269 1323 1338 2736 
1 4 1763 2059 3170 2459 
1 6 1763 1058 2441 1028 3121 2270 
1 5 1763 1321 3107 3096 2263 
1 8 2263 3059 1240 3041 2562 2480 1836 1795 
1 2 1795 482 
1 6 482 1719 2023 1390 2495 2873 
1 7 1815 474 2865 293 1883 1345 2873 
1 7 2263 3090 1967 1249 1672 1446 2038 
1 6 2038 2165 2417 1293 1317 3078 
1 3 3121 2363 311 
1 6 311 1762 3128 3116 2152 978 
1 5 3238 3246 3245 3261 2278 
1 5 1495 1516 758 971 311 
1 8 1712 3326 3314 2088 3285 2319 3261 2278 
1 6 2143 2312 3349 2398 1147 1712 
1 6 539 2074 2890 2870 2868 2873 
1 4 2977 1829 2935 539 
